11111111111111
10000000000003
10111144111110
10115144115110
10111111111110
10100000004010
10111141111110
10100000000011
10111111111111
10111141111100
10115111114110
10111141111110
10000000003000
10211111141111
11111111111111
